NO textures/metroid1.xpm
SO textures/metroid1.xpm
WE textures/metroid2.xpm
EA textures/metroid2.xpm

F textures/floor5.xpm
C textures/floor.xpm

LVL_A start.cub

                                                           
                                                         11111
                  11111                                  10DA1
           1111111100Z1          11111111111111111111111110111
           1000000Z0101          100L00000011000000000000101
         111D11111111L111        101100R0011100Z000A00000101
         1110111 11A000011       101100Z00D0D0Z00000000Z0L01
         1ZD0Ds1 1000000011111111101100000111000000000000101
         1110111 10R01000D0000000001100000111D11111D11111101
         1RD0DZ1 1000000011110111111111011100000010001   10111
         1110111 11H000011111D111111111011101110010001   10Ds1
        1111D11111111D1111100000011Z101011100000010001   11111
       11H000000Z11 101  10000H00000000001100000010001
    1111000000000011101  10000000000000001101L10010N01
    1s0M00100R1000D0001  1111M1111101M10111R1e11Z1000111
    1111000000000011111  110000e1 1Z1R101 111111111211
       11H000000Z11      11111111 1111111 111111111111
        1111111111
