NO textures/metroid1.xpm
SO textures/metroid1.xpm
WE textures/metroid2.xpm
EA textures/metroid2.xpm

F textures/floor5.xpm
C textures/floor.xpm

LVL_A start2.cub

                            1111111111111111111111111 
                            100L000000110000000000001 
                            101100R0011100Z000A00000111
                            101100Z00D0D0Z00000000Z0L01
                    11111111101100000111000000000000111
                    10000000001100000111D11111D111111 
                    11110111111111011100000010001     
                    1111D111111111011101110010001     
                    1100000011Z101011100000010001     
                    10000H00000000001100000010001
                    10000000000000001101L10010N01
                    1111M1111101M10111R1e11Z1000111
                    110000m1 1Z1R101 111111111211
                    11111111 1111111 111111111111
