NO textures/metroid1.xpm
SO textures/metroid1.xpm
WE textures/metroid2.xpm
EA textures/metroid2.xpm

F 0x4d,0x2b,0x0b
C 0x64,0x9d,0xfa

LVL_A lvlb.cub
LVL_B start.cub

1111111
102m301
1000001
1000001
1000001
100N001
1111111
