NO textures/grass_stone.xpm
SO textures/grass_stone.xpm
WE textures/stone_wall.xpm
EA textures/stone_wall.xpm

F textures/outside_floor.xpm
C 0x64,0x9d,0xfa

LVL_A lvlb.cub
LVL_B start.cub

1111111
1121311
100m001
1000001
1000001
1000001
100N001
1111111
