NO textures/norfair_wall1.xpm
SO textures/norfair_wall1.xpm
WE textures/norfair_wall2.xpm
EA textures/norfair_wall2.xpm

F textures/floor_norfair.xpm
C 0x64,0x9d,0xfa

MU resources/sound/lava_music.wav

LVL_A start.cub

                                                
                                                
         11111                                  
         11t11                                  
         10001                                  
   11111111B11111111
   10000000000000001
   10000000000000001
   10000000000000001
   10000000100000001
   10000000000000001
   10000000000000001
   10000000000000001
   10001000P00010001
   10000000000000001
   10000000000000001
   10000000000000001
   10000000100000001
   10000000000000001
   10000000b00000001
   10000000000000001
   11111111B11111111
      11000000011                               
      10000000001                               
      10010001001                               
      10000000001                               
      10000000001                               
      10010001001                               
      10000000001                               
      11000000011                               
       1111D1111                                
         10001                                  
         10N01                                  
         11211                                  
          111                                   
