NO textures/floor3.xpm
SO textures/floor3.xpm
WE textures/floor3.xpm
EA textures/floor3.xpm

F 0x4d,0x2b,0x0b
C 0x64,0x9d,0xfa

LVL_A start.cub
LVL_B lvla.cub

1111111
1121311
100t001
1000001
1000001
1000001
100N001
1111111
