NO textures/grass_stone.xpm
SO textures/grass_stone.xpm
WE textures/stone_wall.xpm
EA textures/stone_wall.xpm

F textures/outside_floor.xpm
C 0x64,0x9d,0xfa

LVL_A lvla.cub
LVL_B lvlb.cub

                    111                                           
                   11211                                          
                   10001                                          
                   10001                                          
                 1111M1111                                        
                11000000011                                       
                10R00000R01                                      
                10010001001                                       
                10000000001                                      
                10Z00A00Z01    1111111111111111111111111111      
                10000000001    1000000000000000000000000001      
                10010001001    1000000000000000000000000001      
                10R00000R01    1000000000000000000000000001       
                11000000011    1000000000000000000000000001       
                 1111D1111     1000000000000000000000000001       
                    101        1000000000000000000000000001       
                 1111M1111     1000000000000000000000000001       
                11m00000011111 1000000000000000000000000001       
                1000000000100111000000000000000000000000001111    
                10000000001000111111111000000000000000000010011   
                10000S0000L000D000000010000000000000000010L0031   
                10000000001000111111101000000000000000001010011   
                1000000000100111000010100000000000001111101111    
                11s00000011111 1011110100000000000001000101       
                 1111D1111     1000000100000000000001010001       
                   1Z001       1110111100000000000001010111       
                   10001       1010100000000000000001010101       
                   100Z1      11010111111100111111111011101       
                 1111D1111111110010000000100100011000000001       
             111111Z00001110ZR11111111110100101011011110101       
             11m1100000001000000111100010111101000010110111       
             1Z0Z10000000M000000mLe100010000001011110000001       
             100011Z0R0001000000111111111111111111111111111       
             10001111D11111Z00R11                                 
             1000D000000DR111111                                  
             10001111111111                                       
             11D11                                               
              1R1                                                
              111                                                
