NO textures/grass_stone.xpm
SO textures/grass_stone.xpm
WE textures/stone_wall.xpm
EA textures/stone_wall.xpm

F textures/outside_floor.xpm
C 0x64,0x9d,0xfa

LVL_A lvla.cub
LVL_B lvlb.cub

111111111111111111111111111111111111111111111111111111111111111111
111111111111111111111111111111111111111111111111111111111111111111
1111111111111111111111111111111111111111111100Z00Z0011111111111111
11111111111111Z11Z11Z1101110000000A11111111ZZ00000Z00D0m1111111111
11111111111101011011011011000000000010000Z11D111D11111111111111111
1111111111120D000A0000000M0000E000R0D00000D00111R11111111111111111
1111111111110101101101101100000000001Z000011M111111111111111111111
11111111111111Z11Z11Z110111000000001111111100011111111111111111111
111111111111111111111111111111111111111111Z000Z1111111111111111111
11111111111111111111111111111111111111111100R001111111111111111111
111111111111111111111111111111111111111111Z000Z1111111111111111111
111111111111111111111111111111111111111111100011111111111111111111
11111111111111111111111111111111111111111111e111111111111111111111
111111111111111111111111111111111111111111111111111111111111111111
