NO textures/grass_stone.xpm
SO textures/grass_stone.xpm
WE textures/stone_wall.xpm
EA textures/stone_wall.xpm

F textures/outside_floor.xpm
C 0x64,0x9d,0xfa

MU resources/sound/outside_music.wav

LVL_A lvla.cub
LVL_B lvlb.cub

                    111                                           
                   11211                                          
                   10001                                          
                   10001                                          
                 1111M1111                                        
                11000000011                                       
                10R00000R01                                      
                10010001001                                       
                10000000001                                      
                10Z00A00Z01    1111111111111111111111111111      
                10000000001    10R1R000011010001Z0000s111m1      
                10010001001    1011110111000010111011110001      
                10R00000R01    1010000000011110000000000111       
                11000000011    1010101111100e11010101110001       
                 1111D1111     1000111000101111110100010101       
                    101        11101000101010001101010101R1       
                 1111M1111     1000101110100R10100101110111       
                11000000011111 1011101010111110111101000001       
                1000000000100111010000010000100Z00001111101111    
                10000000001000110111011111101111111000001010011   
                1E00000000L000D00000Z01Z00000000111111101AL0031
                10000000001000111101101101111110000R00001010011   
                100000000010011100001010000R101110101111101111    
                11000000011111 1011110111111101110101000101       
                 1111D1111     10000001000Z0001000101010001       
                   1Z001       1110111101101111011101010111       
                   10001       1s101e00011000000100010101R1       
                   100Z1      11010111111110111111111011101       
                 1111D111111111R000000000110100011000000001       
             111111Z00001110ZR11111111010100101011011110101       
             11m110000000100000011110101011110100001m110111       
             1Z0Z10000000M000000mLe100010000001011110000001       
             100011Z0R0001000000111111111111111111111111111       
             10001111D11111Z00R11                                 
             1000D000000DR111111                                  
             10001111111111                                       
             11D11                                               
              1R1                                                
              111                                                
