NO textures/grass_stone.xpm
SO textures/grass_stone.xpm
WE textures/stone_wall.xpm
EA textures/stone_wall.xpm

F textures/outside_floor.xpm
C 0x64,0x9d,0xfa

LVL_A lvla.cub
LVL_B lvlb.cub

                    111                                           
                   11211                                          
                   10001                                          
                   10001                                          
                 1111M1111                                        
                11000000011                                       
                10R00000R01                                      
                10010001001                                       
                10000000001                                      
                10Z00A00Z01                                      
                10000000001                                      
                10010001001                                      
                10R00000R01                                       
                11000000011                                       
                 1111D1111                                        
                    101                                           
                 1111M1111                                        
                11000000011111                                    
                100000000010011                                   
                1000000000100011                                  
                10000S0000L000D1                                  
                1000000000100011                                  
                100000000010011                                   
                11000000011111                                    
                 1111D1111                                        
                   1Z001                                          
                   10001                                          
                   100Z1                                          
                 1111D111111111                                   
             111111Z00001110ZR111                                 
             11m11000000010000001111                              
             1Z0Z10000000M000000mLe1                              
             100011Z0R00010000001111                              
             10001111D11111Z00R11                                 
             1000D000000DR111111                                  
             10001111111111                                       
             11D11                                               
              1R1                                                
              111                                                
