NO textures/empty.xpm
SO textures/empty.xpm
WE textures/empty.xpm
EA textures/empty.xpm

F textures/empty.xpm
C textures/empty.xpm

1111111111111111111111111111111
1000000000000000000000000000001
1000000000000000000000000000001
1000000000000000000000000000001
10000000000N0000000000000000001
1000000000000000000000000000001
1000000000000000000000000000001
1000000000000000000000000000001
1000000000000000000000000000001
1000000000000000000000000000001
1000000000000000000000000000001
1000000000000000000000000000001
1111111111111111111111111111111
