NO resources/textures/grass_stone.xpm
SO resources/textures/grass_stone.xpm
WE resources/textures/stone_wall.xpm
EA resources/textures/stone_wall.xpm

F resources/textures/outside_floor.xpm
C 0x64,0x9d,0xfa

11111111111111111
10000000000000001
10H00000000000H01
10000000100000001
10000000000000001
10000000s00000001
10000000000000001
1000D0m0S0m0D0001
10000000000000001
10000000s00000001
10000000000000001
10000000100000001
10000000000000001
10000000R00000001
10000000000000001
10000000000000001
11111111111111111
