NO textures/grass_stone.xpm
SO textures/grass_stone.xpm
WE textures/stone_wall.xpm
EA textures/stone_wall.xpm

F textures/outside_floor.xpm
C 0x64,0x9d,0xfa

11111111111111111
10000000000000001
10000000000000001
10000000100000001
10000000000000001
10000000000000001
10000000000000001
1000D000S000D0001
10000000000000001
10000000000000001
10000000000000001
10000000100000001
10000000000000001
10000000R00000001
10000000000000001
10000000000000001
11111111111111111
