NO textures/metroid1.xpm
SO textures/metroid1.xpm
WE textures/metroid2.xpm
EA textures/metroid2.xpm

F 0x4d,0x2b,0x0b
C 0x64,0x9d,0xfa

        1111111111111111111111111
        100D000000110000000000001
        1011000001110000000000001
        100100000D0D0000000000001
111111111011000001110000000000001
10000000001100000111011111D111111
11110111111111011100000010001
1111D111111111011101D10010001
11000000110101011100000010001
10000000000000001100000010001
10000000000000001101L10010001
11000001110101011101011010N0111
11110111 1010101 111111110001
11111111 1111111 111111111111
