NO resources/textures/grass_stone.xpm
SO resources/textures/grass_stone.xpm
WE resources/textures/stone_wall.xpm
EA resources/textures/stone_wall.xpm

F resources/textures/outside_floor.xpm
C 0x64,0x9d,0xfa

MU resources/sound/dungeon.wav

             111111111111111111111111111111
             1Z000D000000000000000000000001
             1e00010Z0A0000000R00000000Z001
             101111111100000000000000111001
             1010000001100011100000001 1001
             1L1000000010000000000000111001
             10Z000000011111111111100000001
             10A0010000L000000000m1Z0R00001
             101111110011110111101111100111
             10R0000100100000000000000001
             10Z0000100111111111111100011
             1000000100Z00000000000000001
             1Z00000D00000011111111110001
         11111000011111111110000000000001
         100000000000000000Lm000000000001
         1000000000000000001000111M1111e1
         11011111111M11111111111000000111
         10R01011000000000000000000000001
         10Z01101R00000000000001000000001
         10001111111110111011111111111111
         1000000000m1e00100001m0000100001
         111111101111111101000100010010e1
             1000000000010010001010001111
             10000000000100000000000001
             10001111L111111111111111M1
             100010000Z000000000000Z001
             100010000s000000H000000001
             10N0100000000A000000000001
             11111111111111111111111111
