NO textures/metroid1.xpm
SO textures/metroid1.xpm
WE textures/metroid2.xpm
EA textures/metroid2.xpm

F 0x4d,0x2b,0x0b
C 0x64,0x9d,0xfa

11111111111111111111111111111111111111111111111
10000000000000000000000000000000000000000000001
10000010000000000000000000000000000000000000001
10000100000000000000000000000000000000000000001
10001000000000000000000000000000000000000110001
10000000000000000000000000000000000000000110001
10000000000000000000000000000000000000000000001
10000000000000000001111011110000000000000000001
10000000000000000001000000010000000000000000001
10000000000000000001000000010000000000000000001
10000000000000000001000000010000000000000000001
10000000000000000000000N00000000000000000000001
10000000000000000001000000010000000000000000001
10000000000000000001000000010000000000000000001
10000000000000000001000000010000000000000000001
10000000000000000001111011110000000000000000001
10000000000000000000000000000000000000000000001
10000000000000000000000000000000000000000000001
10001100000000000000000000000000000000000000001
10001100000000000000000000000000000000000010001
10000000000000000000000000000000000000000100001
10000000000000000000000000000000000000001000001
10000000000000000000000000000000000000000000001
11111111111111111111111111111111111111111111111
