NO textures/metroid1.xpm
SO textures/metroid1.xpm
WE textures/metroid2.xpm
EA textures/metroid2.xpm

F 0x4d,0x2b,0x0b
C 0x64,0x9d,0xfa

LVL_A test4.cub

                                  11111111111111111111
                         111      10000000000000000001
        1111111111111111112111111 10000000000000000001
        100D000000110000000000001 10000000000000000001
        10110000011100Z0000000001110000000000000000001
        10e100Z00D0D0Z00000000Z0D0B0b0000000P00000000111
11111111101100000111000000000000111000000000000000000Bt1
10000000001100000111011111D111111 1000000000000000000111
11110111111111011100000010001     10000000000000000001
1111D111111111011101D10010001     10000000000000000001
1100000011Z101011100000010001     11111111111111111111
10000Z00000000001100000010001
10000000000000001101L10010001
1111M1111101M10111s1e11m10N0111
110000s1 101Z101 111111110001
11111111 1111111 111111111111
