NO resources/textures/metroid1.xpm
SO resources/textures/metroid1.xpm
WE resources/textures/metroid2.xpm
EA resources/textures/metroid2.xpm

F resources/textures/floor5.xpm
C resources/textures/floor.xpm

LVL_A test.cub

11111111111111111111111111111111111111111111111
10000000000000000000000000000000000000000000001
10000010000000000000000000000000000000000000001
1000010000000000000000BPB0000000000000000000001
10001000000000000000000000000000000000000110001
10000000000000000000000000000000000000000110001
10000000000000000000000000000000000000000000001
10000000000000000001111b11110000000000000000001
10000000000000000001Z00000Z10000000000000000001
1000000000000e0000010000000100000e0000000000001
10000000000000000001000000010000000000000000001
1000002E00000m0000000000000000000s0000000000001
10000000000000000001000000010000000000000000001
1000000000000e0000010000000100000e0000000000001
10000000000000000001Z00000Z10000000000000000001
10000000000000000001111011110000000000000000001
10000000000000000000000000000000000000000000001
10000000000000000000000000000000000000000000001
10001100000000000000000000000000000000000000001
10001100000000000000000000000000000000000010001
10000000000000000000000t00000000000000000100001
10000000000000000000000000000000000000001000001
10000000000000000000000000000000000000000000001
11111111111111111111111111111111111111111111111
