NO resources/textures/grass_stone.xpm
SO resources/textures/grass_stone.xpm
WE resources/textures/stone_wall.xpm
EA resources/textures/stone_wall.xpm

F resources/textures/outside_floor.xpm
C 0x64,0x9d,0xfa

MU resources/sound/outside_music.wav

11111111111111111111111111111111
10000000000000000000000000000001
10000000000000000000000000000001
10Z0A0000000s0000000Z00000000R01
10111111111101111111110111111011
10000000000000000000000000000001
10R0000R0000R0000A0000Z0000Z00R1
10000000000000000000000000000001
10111101111101111110111111101111
10100001000001000000000000001001
10100Z01Z0R00100R0Z0100m00001001
1L101111111111111111111111111111
101010000000000000000000100000W1
1t1010000000Z0A0R000000010001001
11101011111111101111110111101111
10001000000100001000000000000001
1000Z0Z00R0100R0Z01000Z0Z0Z00Z01
10000000000100000000000000000001
10111111110111111111111110111111
10100000000100000000000000000001
101000Z00001000Z0A00R000000R00A1
1010000011111111111111111D111111
10100000D00000000000000000000001
100000Z010000000Z0000m0000Z0R001
11111111111111111111111111111111