NO resources/textures/grass_stone.xpm
SO resources/textures/grass_stone.xpm
WE resources/textures/stone_wall.xpm
EA resources/textures/stone_wall.xpm

F resources/textures/outside_floor.xpm
C 0x64,0x9d,0xfa

MU resources/sound/output.wav

               111111111111111
               1000000000000t1
        1111111110000P00000001
        1m0000ZLB0b00000000001
        1000000111111111111111
        100000001000000Z0000R1
        10R0A000D0000000000001
        100000001R000000001e01
        1000000R11111111D11111
        1000000010000000000011
     111111M11111000011000Z001
     100000000R10000Z110000001
     100Z000000L00000000000001
     1011111111101111111111011
     101000000H101000000000011
     1010s10000100000R1Z0Z1Z01
     1R10000000101000000000001
    11M11111M11101011111111111
    100000000001000010000000H1
1111100000Z000110010L000e00001
1m0010000000001000111000000001
1000D00000A0001000111111111111
1Z00100Z00R0001000000000000W1
11111111111111111111111111111
